remove repeated word::remov repeat word
typo main site::typo main site
add clear blobs ensemble py::add clear blob ensembl py
bug quickstart py::py quickstart bug
added loadbalancing runtime sorting option::option ad loadbalanc runtim sort
parameter set iteration::paramet set iter
iain murray issues::iain murrai issu
args parameter added ptsampler::paramet ad arg ptsampler
documentation clarification ensemblesampler multiprocessing::multiprocess document clarif ensemblesampl
remove unicode dash characters causing encoding errors::remov unicod dash charact caus encod error
added reference testimonials::ad testimoni refer
update testimonials rst::updat testimoni rst
abstract arxiv paper updated::paper abstract arxiv updat
added reference coming::ad refer come
faq add section wrapping pickling parameter limits::add paramet faq section wrap pickl limit
change license::chang licens
large regressions::larg regress
base sampler class returns garbage acor::acor sampler base class return garbag
problems mpi pool::pool mpi problem
include explicit prior documentation::includ document explicit prior
encode option open python::option encod open python
multiprocessing ptsampler::multiprocess ptsampler
return lnprob returns nan::return lnprob nan
require numpy::requir numpi
installation test failed parallel sampler::parallel sampler instal test fail
chunking multiprocessing pool::pool multiprocess chunk
added unittest dead walkers initialized lnprob0 nan::walker initi lnprob ad nan unittest dead
explicitly define complementary ensemble::ensembl explicitli defin complementari
fail initialized walkers inf::walker initi fail inf
add checks parameters nan::add nan check paramet
documentation chain inconsistent::document chain inconsist
push resubmitted version::resubmit version push
update cv::updat cv
post resubmitted version revision arxiv::resubmit version arxiv post revis
gw paper::paper gw
grants acknowledge::grant acknowledg
email editor version coming asap::come version email editor asap
cite papers::cite paper
affiliations publication::affili public
flatlnprobability::
replace::
fix couple comment typos::fix coupl comment typo
parallel tempering sampler based ensemblesampler::parallel sampler temper base ensemblesampl
fixes ensemble py metropolis hastings code path::py ensembl metropoli hast fix code path
typo ensemble py metropolis hastings code path::py ensembl metropoli hast typo code path
fixes typo quickstart page::typo fix quickstart page
modified run python3::modifi run python
submit paper pasp::paper submit pasp
bad performance gaussian likelihoods::bad perform gaussian likelihood
lnprob return extra info::return lnprob extra info
subprocess communicate external programs::subprocess commun extern program
alternative map function::map altern function
priors limits::limit prior
ensemble mh::ensembl mh
document usage keyword argument::document usag keyword argument
eggbox::
transpose bug ensemblesampler acor::acor ensemblesampl bug transpos
multiprocessing resources expected::multiprocess resourc expect
multiprocessing pickling error::multiprocess pickl error
multithread speed scaling::multithread speed scale
make actual code examples::make exampl code actual
downsides walkers::walker downsid
include bovy comments::includ bovi comment
run experiments::run experi
rewrite autocorrelation time section::section rewrit autocorrel time
comment algorithm map ability::map comment algorithm abil
discuss expected squared jump distance diagnostic::expect discuss squar jump distanc diagnost
send paper lang goodman bovy::paper bovi send lang goodman
avoid latin abbrevs::avoid latin abbrev
difference::
hard space::hard space
update pt sampler work::updat work pt sampler
update examples work::updat work exampl
profile walk differential evolution proposals make faster::make profil walk differenti evolut propos faster
combine powers pymc::combin power pymc
closing properly pool sample function ath end run::pool run function close properli sampl ath end
make quickstart work python3::work make quickstart python
chain lnprobability modified iterations::modifi chain lnprobabl iter
added schlaufman casey testimonials::ad testimoni schlaufman casei
multimodal py test ptsampler evidence estimation::py ptsampler test multimod evid estim
added reset burn::reset burn ad
add reset burn method::add reset burn method
lnprob0 rstate0::lnprob rstate
daemon threads ensemble sampler terminating::ensembl sampler daemon thread termin
problems acceptance ratio walkers::problem walker accept ratio
minor pep8 fixes::fix minor pep
memory leak mpi pool loadbalance::pool mpi memori leak loadbal
travis build image compatible high resolution screens::travi build imag compat high resolut screen